asdf: Extendable version manager with support for Ruby, Node.js, Erlang & more
bat: Clone of cat(1) with syntax highlighting and Git integration
blueutil: Get/set bluetooth power and discoverable state
cask: Emacs dependency management
cdrtools: CD/DVD/Blu-ray premastering and recording software
ctags: Reimplementation of ctags(1)
k9s: Kubernetes CLI To Manage Your Clusters In Style!
dive: Tool for exploring each layer in a docker image
dog: Command-line DNS client
duf: Disk Usage/Free Utility - a better 'df' alternative
dust: More intuitive version of du in rust
eza: Modern, maintained replacement for ls
fd: Simple, fast and user-friendly alternative to find
git: Distributed revision control system
git-delta: Syntax-highlighting pager for git and diff output
gping: Ping, but with a graph
graphviz: Graph visualization software from AT&T and Bell Labs
grc: Colorize logfiles and command output
gtop: System monitoring dashboard for terminal
hexyl: Command-line hex viewer
htop: Improved top (interactive process viewer)
httpie: User-friendly cURL replacement (command-line HTTP client)
kcat: Generic command-line non-JVM Apache Kafka producer and consumer
mac-cleanup-py: Python cleanup script for macOS
mackup: Keep your Mac's application settings in sync
mas: Mac App Store command-line interface
micro: Modern and intuitive terminal-based text editor
midnight-commander: Terminal-based visual file manager
mitmproxy: Intercept, modify, replay, save HTTP/S traffic
neofetch: Fast, highly customisable system info script
netcat: Utility for managing network connections
nmap: Port scanning utility for large networks
noti: Trigger notifications when a process completes
openshift-cli: OpenShift command-line interface tools
procs: Modern replacement for ps written by Rust
ripgrep: Search tool like grep and The Silver Searcher
stow: Organize software neatly under a single directory tree (e.g. /usr/local)
switchaudio-osx: Change macOS audio source from the command-line
tldr: Simplified and community-driven man pages
tmux: Terminal multiplexer
tree: Display directories as trees (with optional color/HTML output)
wget: Internet file retriever
x265: H.265/HEVC encoder
